42x42
******************************************
**2* **    *    ** **    * *  ***     ** *
**                                      **
*   * * *  ** * ***  *  *   * ** ** *** **
*  **  * * *  **  **     * * *****  *    *
*   *  *  *****  **      ** * ** * *  *  *
*  *  *    ** *  * ** *  ****         *  *
**  ** *  *      * ** ***     **    **  **
** ** * ******* * * **  *   **  **  *   **
*  ****         **    *     *  **  ** *  *
*  **** *   **  ** **  * *****    *  **  *
*  *       *  * **   **  *  *  **   **   *
*  *  *  **    * * * *    *  ***   *     *
**       * *  *  * *      *    *** *  *  *
** *   *     *    *  **  * *****  *  *   *
** * *  **  *     ****  ***  ****   **  **
** * *   *  **  * **** *  **** * *   ** **
**  ***          *   * **  **      ** *  *
**    *   *** **          **  ******  *  *
**     **   * *  ***   * *    *  *      **
**   *  **   * * ***  *  * ***  * *  *  **
*  *  *  * *   * *  *1                  **
**   ***    * * * ******  *    ****   *  *
*   ** **   **  *       ** *  * ***** *  *
*   ***   * **   * *  **    * **        **
*  **** **   * *    ***  *  * *** * *    *
*   ** ***   *****  ****  *      **      *
*  ***   ** **  ***   * *   ***   **  *  *
*   *   * *         **     *      * *   **
*     ** *  * * * **    *    *      * * **
** * *  *  * ****** *   *** ***  ****    *
*   **** * * ** * * *   **  * ** ** ***  *
*   ***** **  *    *   *  * **   ** *** **
*  *** * *       ***  *** **  **        **
** *      * *** **   **  *** * *** **   **
**    ***     *  **  ** ********    *    *
*   **  *** *     ** ****  ** ***    *  **
** ***  **  *  * ** ** **  **     ** *   *
** * ***** *    ** ***  * ** *  * ****  **
*                                        *
**  *   **    ** *  *   **   *  * **  *  *
******************************************
