AUTEUR : folie_a
42x42
******************************************
**2* *            ** *   **   **  ***  * *
**                                      **
** **      * *** * *   * *  * **  *  *  **
**   *  **  ** *** * **  ***** *   *  * **
**  ** **   * *     * * ***  * **  *    **
**  * ** * *      *  * *  *    *** **   **
**   *    *       ** ***    * *  **  *  **
*    ***  *  * **  *** * *    **  *  ** **
*      * *    **  **       *** * **  *  **
*  ****   *** *   *  ** **  *****  *    **
*        *  **      *  *   * ****        *
*  *** *****  *  ** *   *  *     *    *  *
** * ****   *     ** * * ***   ****  ** **
*  ** *** *  ** *****  ***** * * * ***  **
*      *   ***   *    * **   *   * ***  **
*   *    *      *  * *  **  *****  **    *
*    **   *  *  * * * ***     ** *   **  *
** *  ***   ***  * **  **** *** **** ** **
*  * **         *  * ******       ** *   *
*  *   * * * **   *    *  *  **  * * *   *
** * ***** **      * 1                   *
*  **** ***** ** * *** ****  *      *   **
**  * **   *   **    *   *** * * *    *  *
*    ** *  *  *  *         *   *    *    *
*   *  *  *   **  *** *   **  **  **     *
*    **  **   **   **    * *    *  *    **
** *    *  **  **  * * ****  *  *    **  *
*  *** * ** *   * *   *  *** *    ***   **
*  *** * *   *         ** *****  *       *
**  **     *   **  **   * *           *  *
*  *  *    * * ** **   * *  * ** **  ** **
*  *  **       *  **  ****  ***    ***   *
**     *  *    **** *   **** ****** ***  *
**   *  *    *****     * * * * ** ****   *
** ****  ****** ***** **  **   *  * * *  *
*  **   * ***** *  **   **  **  ** *  *  *
*    ** ** * * *   *   **  ***** * *  * **
*     *  * *  *    *  ** *** * **** * *  *
**                                       *
*   **   *     *  * * ** * * *** *  **** *
******************************************
